```
                               . ...............                                                                                                                                                                                                                                                            
                               . .....................                                                                                                                                                                                                                                                      
                               . .........................                                                                                                                                                                                                                                                  
                               . ..............................                                                                                                                                                                                                                                             
                               . ..................................                                                                                                                                                                                                                                         
                               . .................................:                                                                                                                                             ..........................................                                                  
                               . ......... ........................                                                                                                                                            ...........................................                                                  
                               . ........     .. ..................                                                                                                                                            ...........................................        .                                         
                                 .   ...            . ... .........                                                                                                                                            ...........................................        .                                         
                                          ....            .  .. . .                   ............       ..                                                                                                    ...........................................        .                                       . 
...                                                .             ..                                . ..                                                                                                        ...........................................        .                                  .      
............                                                    .                      .....      ...... .    ..     ...                                             .                     ..  ..              ...                                   ...:.                                                  
....................                                                                   ............ .... .    ..........  .                                          .                          .              ..                                   .....                                 .                 
......................       .                                                         ............    . .    ..........  ..                                         .                          .                                                                                    .                      
...     ..............       .                                                                                                                                       .                          .                                                                                                           
.          ...........       .             . .                                   .. ...     . ......... ........... ............................ .....  .            .                          .                                                                                                           
            ..........       .                .                                  ..                                                                     .            .                          .                                                                                        .     .            
             .........       .                .                                  ..                                                                     .            .                          .                        .                     .                                         .   . .            
             .........       .                .                                  ..  .. ...                                          .. ..              .            .                          .                        .      .         .    .   .                                     .   . .           .
             .........       .                .                                  ..  .. ...   . ..         . . .           .   .        .    ... ..  .. .            .                          .                        .      .         .    .   .                                     .   .  .     ......
             .........       .                .                                  ..  .. ...   .  .         . .  .          .   .        .. . . . ..  .  .            .                          .                        . .. . . .   . . ...... . .                                     .   .  .         ..
              ........       .                .                                  ..  .. ...   .  ..          .  ..         .   .        .. . . . .. ... .            .                                                   .. .   .         .    . ...                                     .   .  .    .....  
              ........       .                .                                  ..  .. ...   .   .          .   ..        .   .        .. . . . .. ... .            .                      ..                           .      .         .    .   .                                     .   .           .  
              .  .....       .                .                                  ..  ..  .    .    .         .    .        .   .           .  .  .. ... .            .                                                   .  . . ....  ....... .. . .                                     .     . ..         
              .  .....       .                .                                  ..  .. ..    .                    .       .            .  .  .. ..  .. .            .                    .                              .      .         .    .   .                                                        
             ..    ...       .                .                                  ..                                                                     .            .              :...        .                        .      .         .    .   .                                                        
       ...  ..     ...       .                .                                  ..                                                                     .            .              .:.:--.     .                        .      .         .    . . .                                                ...  . .
    ...  ....      ...       .                .                                  ..                                                                     .            .                .......   .                        .. . . . ... . . . .  . . .                                             . .....    
                   ...       .                .                                  ..      .  ..  .                                             ..        .            .                   ..::.  .                        .      .         .    .   .                                          .. . ....  ...
...                ...       .                .                                  ..  .. . . .. .    . .                               . .        ..  .. .            .                     ..  ..         ..             .      .         .    .   .                                        . .. . ...   ...
.                  ...       .                .                                  ..  .. . . .. .    . .                               . .    ... ..     .            .                         ..         .              . . ......   . . .  ...                                            . .. . ...   ...
                    ..       .                .            .:::::::::.                       . .    . .                               . .    ... .. ... .            .                         ..        .               .                      .:::::::::                                  . .. . ... . ...
                    ..       .                .            .*########*=++++++++++:::::::::::.                                           .    ... ..  .. .            .                         ..                       ..::::::::::::=++++++++=+########=                                  . .. . ... . ...
                    ..       .                .            .#%##***%%%%%%%%%%%%%%###########*++++++++++++=::::::::::...   ..                                                                 .. . .:::::::::=+++++++++++##############%%%#######%%%%%%%%%+                                  . .. . .....   .
......................       .                .            .#%*#**#%%#*#********##############%%%%%%%%%%%%##########%*:.  : ----------------------------------------------------------------- : . =#########%%%%%############*******++++++***+**%%%%%%%%%+                                                  
......................       .                .            .#%##***#%%+----------+++++++++++++++*+++#%%%%%%%%%%%%%%%%%*   :.###*#########*#****#*#**#***#####################################..   *%*++++++++++++*-======-----=-====..........:*%%%%%%%%%+                                                  
......................       .                .            .#%%#****%%=::-=.=-::-::.::::...........=#%%%%%%%%%%%%%%%%#+   . **#+++*%##%%#*%*+++#+#==*+++*##%%%%%%%%%%%%%%%%%%%%%%%%%%%%%%%%%%..   +%*:-=+--=-....+:--====....:-.==:=........+:.*%%%%%%%%%+                                                  
......................       .             ....            .#%*#***#%%=-:.==:==+::-::::-...........=#%%%%%%%%%%%%%#*-.   ... .:...::**#%%*%#***%*#****##*%%%%%%%%%%%%%%%%%%%%%%%%%%%%%%%%%%%%..   +%*..:=:-=.::..=:-::::-==-:---:::=....=.:.*-.*%%%%%%%%%+                                                  
......................       ......                        .#%*#**#%%%=-:-===-.....................=#%%%%%%%%%%%#=.         ::.     .+%%%*%#++++*##*#%#%%%%%%%%%%%%%%%%%%%%%%%%%%%%%%%%%%%%%%..   +%*..:+-=--+-:.+:.-*=.:..-=::*-::=-:..# ==*-.*%%%%%%%%%+                                                  
......................                                     .#%##**#%%%=::.-::::::-.-:.:-.-.........=#%%%%%%%%%%%-             ::.     .+#*%%%*+#+*%+++++++##++++**#%%%%%%%%%%%%%%%%%%%%%%%%%%..   +%*..:--=---...+:=+--+*==*%**=*+:=+-=:#.==*-.*%%%%%%%%%+                                 .   .            
......................                                     .#%##*#%%%%=--.-::::::-.-:.:-.-.........=#%%%%%%%%%%- .            ..-.      #*%%%#*%##*##%%%%%%%%%%%%%%%%%%%%%%%%%%%%%%%%%%%%%%%%..   +%*...-+=*==-::=:-.......:=...:.:=+-*:#-==*-.*%%%%%%%%%+                                 . .   .  .       
...........                                                .#%*#***%%%=.:..........................=#%%%%%%%%%=                ..-    ::#*%%%#**+*=+#***###%%%%%%%%%%%%%%%%%%%%%%%%%%%%%%%%%%..   +%*:::=:.......+:::-=====--==-==:=+-=:#:==+:.*%%%%%%%%%+                                 .   . .  .       
                                                           .#%%#**#%%%=............................=#%%%%%%%%# .                .:: . +%%*%%%%%*+***%+**#*#%%%%%%%%%%%%%%%%%%%%%%%%%%%%%%%%%%..   +%*..=-==--....+:-==+-===----::-:=-:-.=.---:.*%%%%%%%%%+                                 .     .  .       
                                   ...                     .#%%%%%%%%%=............................-########## .                ..- -+.*#*%%%%%***#**#**##%%%%%%%%%%%%%%%%%%%%%%%%%%%%%%%%%%%..   +%*...==-=-:...=-====-====-----==+--=-=---=--*########%+                                 .     .  .       
                                                      .    .#%%%%%%%%#+----------------------------=+++++*+*+*:.                  ..-+ *%*%%%*%###%%%%%%%%%%%%%%%%%%%%%%%%%%%%%%%%%%%%%%%%%%%..   +%*..:+:---....=====================+*++++++*+++*+*+**%+                                 .   . .  .       
                                  .              .    .    .#%%%%%%%%%%%%%*============---.......::..........** .            .  ..::: -%%*%%%++**##+**%+*#++%+*##*#*%***#%%%%%%%%%%%%%%%%%%%%..   +%*...--==:....+:-.==:-+-:=::........:::::::::::::..:*%+   .                             .   . .  .       
                                  .         ..        .    .#%%%%%%%%%%%%%*.+==--.===: ......::..........:...+%= .           .  .:::: *%#*%%%*++*#*+*+++***++##%%#%#%###%%%%%%%%%%%%%%%%%%%%%..   +%*.:.-::-:....+:..:-=+=:===-.-.-...................:*%+      ...                                 .       
                                  .         ..        .    .#%%%%%%%%%%%%%*:+--+-:---                ....:::::=#:.           .  .:::: +%#*%*#%##%%%%%###%%%##%%%%%%%%%%%%%%%%%%%%%%%%%%%%%%%%..   +%*:.:=:-==:...=:..:+=+:=:=:--:=-:--:--:-.-==.......:*%+                                   ..             
                                  .  .      ..        .    .#%%%%%%%%%%%%%*.-::=--.=: .                    ..:.+#...         ..     ::*%%*%*+++%**%*#%%%%%%%%%%%%%%%%%%%%%%%%%%%%%%%%%%%%%%%%..   +%########*#+==+:..:+=+-=-=--:.::..........::.......:*%+                                           .      
                                  .  .      ..        .    .#%%%%%%%%%%%%%*:=.-:-=:=: .                    ...::+*.         :-.....=:=%%%*%%%++++*##*#++***%%%%%%%%%%%%%%%%%%%%%%%%%%%%%%%%%%..   +%%%%%%%%%%%%%%#:..:++-:-=-:-.......................:*%+                                                  
              ....                .  .                .    .#%%%%%%%%%%%%%*:+===:.=.-:                      ..::-@. : ..  :----:--++:+%%#*%%%%=+*****%###%%%%%%%%%%%%%%%%%%%%%%%%%%%%%%%%%%%%.. . +%%%%%%%%%%%%%%#:..:+-:=---.-+===--:-=:-.:..:.......:*%+                                                  
            ......                .                   .    .#%%%%%%%%%%%%%*..........                        .::=#:=---------== .-=--%%%#*%%%%+*****+***+*#%%%%%%%%%%%%%%%%%%%%%%%%%%%%%%%%%%.. . +%%%%%%%%%%%%%%*:..:-::---:..:.====:-===.:.::.......:*%+                        .                         
            ......                               .    .    .#%%%%%%%%%%%%%*..........                        .::..:.::::----=*-::---#%%%%*%%%**#%########*#%%%%%%%%%%%%%%%%%%%%%%%%%%%%%%%%%%.. . +%%%%%%%%%%%%%%*:=..:====...........................:*%+                       ..                         
            ......                .                   .    .#%%%%%%%%%%%%%*...........                       .:. ::........ :- +%%%%%%%%%*%##***%*###*%%%%%%%%%%%%%%%%%%%%%%%%%%%%%%%%%%%%%%%.. . +%%%%%%%%%%%%%%*:..:==+:=-:==-::--..................:*%+                       ..                         
            ......                    .   .     .     .    .#%%%%%%%%%%%%%*.............                     ...:::::::::::::-:-:++#*###**#******+****#####################################*#..   +%%%%%%%%%%%%%%#:..:=====-.-----....................:*%+                      ...                         
            ......                    .   ..          .    .#%%%%%%%%%%%%%*---------=******#-      .-:      ...:::::::::::::::-====-. .....................................................::.:  .::::+++==#####%#*****=-----=====-...................:*%+                      ...            .            
            ......                    .               .    .#%%%%%%%%%%%%%%%%%%%%%#######==+:      ..--......:::::::::::::::::::::--==:::                                                                  ......=+====*###########****#*------.......:*%+                     ....               . .       
            ......                                    .    .#%%%%%%%#######=======:...:::.          .:::::::::::::::::::::::::::::::..-++=.              ......                                                       ............:======#############+#%+                     ...            ....          
            ....                               . .    .    .*#--====:............ .:......:.:       :......:...:::::::::::::::::::: .::-=++-             ......                                                               ................:=======###=                    ....              .......     
            .   .......     .     .            . .    .    .:.............        ..               .................:::::::::::::: .:::::+++:    ......          ........                                                  .....          .....  ........: .                  ....         ..       ......  
             ....     .......     . .  .       . .    .     ..              ..... .                          .........::::::::::: .:::::::=++.                              ....  ...... ........................  ....... ......   ......            ....                    ...              ..        .  
      .......   ........          .    .       . .    .                   ....... .                              ...:: :::::::::: ::::::::-+++. .................... .......:::::. ...:::...........:::.  .   ......         ....   ........                                 ...                            
             .......     ....     .    .       . .    .           :::::::....     .                                ..:. ::::::::::::::::::::=++.:::::::::::::::::: ...::::::--------:........::---:.:........... .........         .       ....                              ..           ..             .. 
            ...          ....     . .  .   .                      :.....:+ .    ...                                 ..:..::::::::::::::::::---==.::::::::::.:.:::.-+::-.. -::.:.:.::==---::::: .-----:::-:::--::........::.............     ......                          ... .         ..   .            
               ...      .....     . .  .                       .: .::::=-= ...     .                                 ..: .::::::: :::::::::::--+=.---:-:::--:::::==-----: .-:::::::::===.:::::::. .. ....::::-==-----::::........:...    ..:........                       ...             .   .            
            .....   .........     . .  .                       :  .::::::= .::::::.                                  ..:..:::::::. :::::::::::-=+=.::--:---:-:.++=-----:::: :::-:-::::==-.:-::-: .::---:..:-::.-======--=:::::.::::...................                     ...            ..   .  .         
            .................     . .    .                 ... .. .::::--= -..::::-                                   ..- :::::::.. .::::::::::--.. .......... =+-------.    .....:.:.-==-.:-::::...:..:. :-:-:::-=-.:::.:::-::..:-:-.:::::::............                 ....            ..   .  .         
            .................     .   .                 :::::::.. :::::--= -.:====:                                   ..:..::::::::. ::::::::::..=+- ...... .:-==-----: ............. :===-.:-:---..     ::::::-:.:--..::::   :--=::--------:.  :-:.  ..:::.             .....            ..   .  .         
            .................     .                  .--=====---:..::..::::=-::::::.                                   ..: :::::::::. .:::::. .:-+++-    .::=+=----...................:====-.:::::::::::::::::::::: ==-:::. -++**-=:::..::  . .......:---===-..          ...              ..   .  .         
            .................                     .-=======--::::::.....:-======---=:                                  ... .::::::::-: .. .::-----=++= -+++==-----..:--=====================-......................:=======------+++=-::::::::::::----=========-.                         ..   .  .         
            .................                    ..:....................::......:::::                                   ... ::::::::=+... :---------=++===------:  ..:......................:......................:.....::::....  .:=*+:   .....:................                        ..   .  .         
            ................                    ......................................                                  ... .:::::::=+. .. :---------=+=-------. ...................................................................  :............................                            .  .         
            ............                                                                                                .... ::::::-=+.      :---------------:                                                                                                                          .         .         
            ..........                                                                                                   .....:::::-=+.        :-----------:.                                                    .                                                                         .        ..      
            ......                                                                                                       .....:::::=-=:         .::------.                                                       . ...                                                                         .            
            ..                                      ...      .                                                            ..:..::::-:=+             .::                                             .            . .:::.       .   .  . .. .    . -. ..     ...                                 . .         
                                  .    ..           ...   .                     ..                                        .... ::::---== .....            ..                                                     . --=--: .     ................. ....      ...                                     ..      
                     ........         ...           ...   .                 .    .                                         ... .::::--=+. ..       ...:::---:::                                      .           . =::-=: .                                 ...              .......   ......          .    
                 ..........    .  .......           ...   .  ...............-    .                                          ....::::---==   ...::--------::....                                                  . --:-=: .    .                      .     ...               ... ... .. .......         .. 
               ..........     .........  .          ...   .                      .                                          ... .::::::..:---------::: .                                                           :-==-. .    .                 .:.  .     ...                  .. ..  ..........          
       .   ..........   ..  .........  ..           ...   .  .................   .                                          ... .::: .::------::.             .   . .                                              .:-:.: .    .                      .     ...                    .. ......... ....        
      .............      .........   ... .......    ...   .                      .                                           ... ::.    ..:.             ..           ..                                         . ...... .    .                      .     ...                                             
                     .......... . ....  ..  ...     ...   .  .................   .                                           ... :::.               .           ..     .                                         . .....  .    .                      .     ...                                             
                 . . ........  .....  .... ..       ...   .   ................   .                                           ... :::::.            .        ...    .    .                                        .   ...  .    .                      .     ...                                             
                 ..   ....     ..  ........         ...   .                      .                                           ... ::::.   ...       .   ..             .                                            . .... .    .                      .     ...                                             
                 ..   .   ..  .  ........           ...   .  .                   .                                           ... .     .....      .                    .                                         .   .... .    .                      .     ...                                             
                                                    ...   .  .                   .                                           ...    .......            ......      .   .                                         . .  ... .    .          ...         .     ...                                             
             ................... .......            ...   .  .             ::    .                                           ..  .......           ......       .      .                                         .  .: .: .    .      .-:.:-.:-....  ..     ...                                             
                                                    ...   .                      .                                         ..                    .              .      .                                         .   ::.. .    .      .::.:-:.--..   ..     ...          ...                                
                                                    ...   .       ............   .                                           .............                     .      .                                          .    .:: .    .      .   ... . .    ..     ...      .  ....       ..                       
               ......           .......             ...   .  . -. ............   .                                        ............                       .        .                                          .      . .    .      .  .           ..     ...        .....      . .                       
               .......         . ...  .             ...   .  . .  ............   .                                                                                   .                                           .        .    .       ::     :..    ..     ...                                             
```